10,8
0000000000
1111011100
0101010111
0101010100
0100000100
0111100100
0100111100
0000000000