9,8
000000000
111101110
010101010
010111010
010000010
011110010
010011111
000000000